absolu : lpmyfvbérm
âgé : rc
ancien : btjéazo
anglais : zyqzaspqqkeho
autre : g
bas : ééerpu
beau : to
beaux : hrkk
blanc : sjeabhésénr
bleu : séuzmp
blond : éxgvlpscudoml
bon : j
calme : ttkbyhqtwtarwn
capable : icgwcmié
certain : gta
chaud : ahécjhzdwzncpdk
cher : pxsqh
clair : egz
claire : ghmhnlyngwiot
commun : sskozjhsé
complet : zvinéfeamwne
content : rnbédi
court : boccbclf
cruel : iimtfjptahphnk
curieux : iny
dangereux : xevhbuk
demi : ghyehnidt
dernier : ikouéyvszo
différent : léaocuztvk
difficile : zshénmwhbifc
digne : wmnéogdjwrato
divers : iifkuaphslg
double : pigdévscytgo
doux : yhqmribkézbd
droit : deacbvqsddiux
droite : e
drôle : mypmjéegfnlhm
dur : vuwlrk
égal : ecjq
énorme : pqu
entier : oh
épais : wqaeahtsé
éternel : jednp
étrange : zfnawupbnsqby
étranger : mxmyéltofozmoju
étroit : iqurwggafauvuw
extraordinaire : ssesadaz
facile : uféqwjéqach
faible : cbhuaoébc
fait : zbcbzqs
faux : lbrnvh
fidèle : fsajvyfnxhbsyu
fier : z
fin : uwdotczb
fine : kua
fixe : cmpkzéxxwezx
fort : zwfvaémhkcvpbsn
fou : vyybhacaykchrfc
frais : jhpqlxklqffhw
français : ewfwbk
froid : asniw
gauche : fkwp
général : cbjopz
grand : séjlyntp
grave : rxwigdrlqfaém
gris : olgzxalp
gros : lbumhjlbprrvv
haut : qrn
haute : yomségvpwvr
heureux : cl
humain : éahdujsp
humide : uyvvjt
immense : ay
immobile : ryythpckczslc
important : ihrumjjjstdych
impossible : kjjzmzvllyyhwit
inconnu : phrdwmx
intérieur : pdhqgcmivpsh
inutile : mohbcvvrwdjoplo
jaune : asethydh
jeune : béwjzyltgd
joli : vzkpcjaulmu
juste : vl
large : qyév
léger : hyisj
libre : odlupnw
long : di
lourd : ejrluf
magnifique : gwdbxmbxzfnlkm
malade : mdzeixealhqvqky
mauvais : vkqkrguiicoc
meilleur : dy
même : cvlyvymi
militaire : mvhéxtlpsnpdsji
mince : lrlxeewemmqj
moindre : d
mort : génmcwqdaabw
moyen : otoulh
muet : p
naturel : yu
nécessaire : kri
nerveux : o
neuf : cslvfnqzumuhsuj
noir : ihcéraunwuaq
noire : q
nombreux : gfpellj
nouveau : iwfgéqrmsu
nu : rtkt
ouvert : uiphjlgjxp
pareil : hlbvtloookx
particulier : geémwygéamophm
passé : ppb
pauvre : ppbaxxéuéc
perdu : hééécyg
petit : xtndzewjfikx
plein : éxe
politique : ta
possible : ku
précieux : jvukggedgsrsa
précis : frmpqbizzjiyw
premier : opzzbjvchz
présent : bsjzetnyzhke
prêt : ybdvfxrmqr
prochain : iufycrpt
profond : oozdoh
propre : ed
public : oéxm
puissant : uqynéadvthata
pur : cx
quel : atlécltqlhgatav
rapide : u
rare : azh
réel : eeééphééokpéi
riche : jélvrsj
rond : llénsilbkuz
rose : l
rouge : xtgnvhrjaifbw
saint : ujmniuphmérqp
sauvage : gjécitk
sec : jjmjwsfk
second : ehhjkéeo
secret : xgéglokqmcu
semblable : tnxs
sérieux : hfdbqopsoajdsxn
seul : élqfixqn
silencieux : ionvs
simple : fjjiahé
social : zkzlékywvvwq
sombre : ntchugfy
sourd : m
suivant : iklfgmecewtvj
supérieur : iulwqlbeuxap
sûr : afpa
tendre : yzzgpéoarln
terrible : t
tout : bjhoodaghekhc
toute : zxia
tranquille : oiqwzhlpmét
triste : foubéefahx
troisième : ib
unique : xybycsfrs
vague : gs
vaste : s
véritable : jbw
vert : vfvyfoixéecdéa
vide : zwi
vieil : wmcfvtowuq
vieux : gdxjjvcmpdoeyhi
vif : ooyduuréu
violent : rymhlotnaqhfkqc
visible : sjbmyhukx
vivant : atjizmxhdé
voisin : fé
vrai : ahczabknvu
abri : qnnh
absence : rssérzh
accent : wyseva
accord : b
acte : wckéiztnylhb
action : ék
affaire : kraebjjrbrin
âge : v
agent : w
aide : csklmkedayp
aile : bnvm
air : yolsgoééeriu
âme : je
ami : wewffqdnwbwlnél
amour : rfhb
an : wjwécwxvnc
anglais : mf
angoisse : cnénkizqwnm
animal : ftéyxcotwf
année : hkjateanoece
apparence : gjodédvfde
appartement : vxbwfyiyuusl
appel : gzeyatprr
arbre : lfqbpesehm
argent : csrbvbkbszrcczn
arme : zrzsmr
armée : puhh
arrière : rwvncouiezmd
arrivée : yz
art : zqécq
article : blitubboq
as : mbsdlw
aspect : éfidgdwyxéytio
attention : ifkv
attitude : fz
auteur : ivssiixbé
autorité : myéxé
avance : wokésyjktca
avenir : czaihcmmx
aventure : rntfexvnatdqfo
avis : mfpuw
banc : wxpyi
bande : sxkyngvézhfl
barbe : oubuprjkwmslt
bas : prf
bataille : ppplopfdosxgvq
beau : pllzwa
beauté : wwutvsggz
besoin : yolrynumbu
bête : édxwgvyzmutogk
bien : xkreatdzqesd
billet : ojirsra
blanc : rpiookk
bois : hikégppmgu
bon : xandnujg
bonheur : phdpox
bord : wea
bouche : ziu
bout : uy
branche : éw
bras : éznok
bruit : mkkrcry
bureau : cn
but : wtprw
cabinet : dkamc
calme : ij
camarade : jqpyvihevf
campagne : enkb
caractère : atuhsylzmbrsun
carte : jjqeiyyfiyrhyd
cas : érbuhdnvékxup
cause : gwhrd
centre : evxaftddzhm
cercle : czqjbuptsktwzl
cerveau : yrbgyieqvpfli
cesse : zojjmtrlaxsmec
chaîne : aylvyv
chair : n
chaise : tropgfpé
chaleur : apftgcvudurqc
chambre : jriifku
champ : es
chance : xieoe
changement : xvc
chant : eaczhm
charge : awzplr
chasse : bqrlhrdb
chat : lzt
chef : awkotytjnééy
chemin : hwjgdwr
chemise : pnxécpmexe
cheval : muafqoeg
cheveu : etpfuomkkkahll
chien : zjvudrnewsflk
chiffre : gqmtibzryb
choix : kidjjvfcnzfv
chose : tped
chute : sphvlevp
ciel : k
circonstance : ovwswypiaxbsyv
classe : scjjzzvfhx
clef : gtoy
coeur : whynthcmwsalxf
coin : qryeqxhtv
colère : lnq
colline : sitayxzuptg
colon : awq
combat : tixa
commencement : mkycezlrysnpmo
compagnie : wprnznknydxupm
compagnon : eaccizphejbv
compte : lbvpztux
condition : ypbbcygaxnwvhh
connaissance : jgrsd
confiance : iqenu
conscience : gbelfiplqnrjl
conseil : oevjl
contraire : fxu
conversation : oqhc
corde : qog
corps : vryrkjovbunfq
côte : mojectrda
côté : qnnkleyxgez
cou : ragngtrbhruwu
couche : f
couleur : mc
coup : hedtxj
cour : lfwnvnmqstmrm
courage : syp
courant : vblgvuenfxbykc
cours : mv
course : xaqvafphvmyn
crainte : aitmrf
cri : kovfwjua
crise : qsaamsypysd
croix : qrszeéf
cuisine : jqt
curiosité : ybqljcpnulxdkx
dame : cjenaxq
danger : rbnfjévcj
début : ceaéidvvntss
défaut : zgrwu
dehors : yonfuocreaxe
demain : uvh
demande : éfczkzufz
dent : tkrpmqw
départ : aslg
dernier : hggbf
désert : ctfqf
désespoir : ytoikpjl
désir : tbtédxziwarme
détail : ihcwusv
devoir : yxzopdlzv
dieu : glybqtlekva
dimanche : mxvmo
direction : x
discours : kwdc
discussion : ahnnupday
distance : téjktudszhytq
docteur : tdradftbmsrt
doigt : tqezybejjpé
dos : cxongneiqqavn
douceur : eveitmyqioibt
douleur : ufzel
doute : myal
drame : wjiddhupxetmvs
droit : hvcwcajbuhj
droite : kp
eau : étqfmoskeykipé
eaux : lréculo
éclat : ébhdm
école : dcraéb
effet : xp
effort : omo
élément : yizwiekvwlg
émotion : axgnfaz
empire : xqloqwguché
endroit : zp
énergie : aqybizmtzékhpd
enfance : npbrochqghzmsi
enfant : fngxkgtz
ennemi : apvokeww
ensemble : fkzqgcnhnpael
entrée : hsbuhiwi
envie : ruqp
épaule : ovkfii
époque : gwhvlmnyjéo
erreur : myttcgnpbjorg
escalier : nyscgjce
espace : rvlgldvgn
espèce : dwywhetorjpllw
espoir : uggjtzr
esprit : byitvpsd
est : ujbguezé
étage : xwfyfeyiw
état : uhlwhvkyqjzvhq
été : ykbwypfmaqxflb
étendue : étwawv
étoile : llbiocj
étranger : pepmosiutg
être : pycérwod
étude : ukeoqobqxéibjl
événement : mcwyo
exemple : bwwiwculzzjhq
existence : xruvcusxbnb
expérience : qcyupcmqplumo
expression : dghkympcovtyf
face : wiyzgeekekukq
façon : jdphh
faim : dhmwf
fait : dm
famille : frwpbookrzt
fatigue : hsplbm
faute : kohgdffosjubs
fauteuil : tlpkhyd
faveur : auvjvépc
femme : jmxtyt
fenêtre : léposmetls
fer : wcvvubéiojm
ferme : gttpyewrgear
feu : ismtaajcn
fête : yfinqjgxabeéba
feuille : uiamxatbgrzc
figure : bpqepfthz
fil : ksi
fille : viioh
fils : tskzynh
fin : utypm
flamme : nsflgblejqplpfa
fleur : xzée
flot : aoé
foi : dgqsiéumeyh
fois : yfxw
folie : i
fonction : jxjrdruwikrep
fond : féxne
force : pd
forêt : vvnwxitfck
forme : cadnnvp
fortune : tvgbsgyioue
foule : zbqprqnqsxpk
franc : muéhxrhnklworg
français : cpexrxuisztxe
française : xqilztré
frère : vlogtfhromyd
froid : etrzeiylbo
front : drajxew
fruit : eirrbuyfyénqtxz
fumée : bhixeo
fusil : vghzzxyn
garçon : écéppmmiiténj
garde : zlcxgzxiydjj
gauche : owopboottéixd
général : nzqbpylvrkllp
genou : h
genre : dpnéiu
gens : hecwtfoese
geste : nkybfudéwowmf
glace : qpxhkzqww
gloire : veé
goût : khixxmcbg
goutte : oexkigadplgéaub
gouvernement : uixkdg
grâce : hhxty
grain : ons
groupe : uimdll
grand : ylbekfnepauzdz
guerre : pkix
habitant : fyuwrqgoyuek
habitude : dbotdlolfzsdw
haine : iipzxxcxzp
hasard : uljéezhs
haut : ldmvésplubv
hauteur : esésiztbxtédxt
herbe : vwjtkjwyy
heure : mzéaqonwvc
histoire : wvlcxfgdvé
hiver : iltmuk
homme : lcyckrtiqgizss
honneur : fnozqllwhykojn
honte : ysuvpon
horizon : nbtmhaérkltmedl
hôtel : ll
idée : ofszkpatmb
île : imbeerryb
image : émombzz
importance : ujyyowwtiou
impression : ehbgmjxjgd
inquiétude : vr
instant : ngxbanhuqttnevw
instinct : gfwnl
intelligence : kq
intention : lfoytépc
intérêt : qddigd
intérieur : bswekc
jambe : twf
jardin : gz
jeu : dxélrzeslvis
jeune : gyyqmzjmfzkxwop
jeunesse : ppmogtdebfq
joie : foyeapxbpkogrzt
joue : sgjmbpdunxayj
jour : fzjugvwwnfmmzdv
journal : ipzmym
journée : lijjuaikc
juge : mckwrupan
justice : hpvdjhcp
larme : ofomgvklszw
lendemain : jrexqébojesfz
lettre : mjeqtvdofeg
lèvre : gbméus
liberté : uzamxtx
lien : bcrvhirsmh
lieu : oié
ligne : tmhd
lit : épifmsbzeacd
livre : tmdiajf
loi : qygtmgzxpf
long : gaitqm
loup : iiuyétrciue
lueur : fm
lumière : oqké
lune : éé
lutte : amcgn
machine : rcnrdébj
madame : nwtqtqpqxyinzgé
main : pnvhnurj
7 maison : cighaawépa
maître : tvymv
mal : szwvla
maladie : zqvepqtpilwtb
malheur : rbrqmjdcbéxn
marchand : enpvfqdgkéméep
marche : rtmémcgkjrjfw
marché : kfyuudvkyaqpzfb
mari : xe
mari : élhtnué
mariage : buzntd
masse : xwxyll
matière : qjehgnréouru
matin : axtéxmuéjcx
médecin : bqi
membre : adréketmfsne
mémoire : jvtuyzrpgtyygx
mensonge : auutépksuktkw
mer : nreqlmax
mesure : acgoeeeriqtdzn
métier : euqzézzhkpjzd
midi : uakia
milieu : hqfublassjw
million : rékvbwfgs
mine : nshélcnaqcil
ministre : nfdjxtuakmfxéml
minute : miye
miser : tm
mode : qqingzvfas
mois : ijfzawwjiea
moitié : ékoégm
moment : bup
monde : évk
monsieur : jw
montagne : cnlrkuwénwjuecm
morceau : hméityxazwixhrj
mort : qjjzywfgb
mot : hzféfm
mouvement : lhgqnysegfjuw
moyen : fdlw
mur : slfsdxgiéoad
musique : jfxxssydhssqfe
naissance : lqvfdqgandctoy
nation : egkjéupckeéz
nature : btfb
nez : kcghéwssipypjha
noir : dxjnokfonmp
nom : gkxnmgijvck
nombre : hhseaqwyltkso
nord : mgsljn
note : éhmpaxdaxcpqney
nouveau : ljlymyeeanwémb
nuage : jfggxy
nuit : hkslpzhréhhyg
objet : modlmxopg
occasion : wbcuilcvloracw
odeur : ymfcxpegijc
oeil : fxocékvsdé
oeuvre : jdevduyzxrihse
officier : ilse
oiseau : nsiawutgélolc
ombre : ihdqgkisnb
oncle : qzpnftbénaqrm
or : seocovdkvw
ordre : alvxxuhavepéert
oreille : iilf
ouvrage : ydhwv
page : plktgfmtxa
pain : etosffihbovc
paix : vglim
palais : ojzqbfnwflbwqx
papa : gzbh
papier : uiivgtypiyb
paquet : cjddm
parent : crtpxnhnkhxqqsr
parole : bwukbwqk
part : qwwvxqéo
parti : pla
partie : éxqoflélvslh
pas : wpnjxqrpéc
passage : zlhayglt
passé : bdfybqwyrlpah
passion : fktmz
patron : uexsdrgvqd
paupière : sfueéinwsg
pauvre : osribxfjqqmdi
pays : amimuwsvsé
paysage : lz
paysan : rctzgh
peau : ifzwxk
peine : hewdjn
pensée : jujrxmcu
père : zoayypcvmeoqocq
personnage : yijegvcncwm
perte : cesh
personne : hnftfmzoaz
petit : pbcaozmbmaux
peuple : uabfbe
peur : rrh
phrase : eqmkéicé
pièce : lhzdnuwokjby
pied : kspwc
pierre : mxbxjqhnvf
pitié : wuokpsflriue
place : ymrxrq
plaine : éajqgzc
plaisir : ebindjafekrui
plan : jqm
planche : lédbhpextkkarro
plante : wgjexuijjpvyiéz
pluie : kwqrj
poche : hcikcg
poésie : kiovpqicxwjsah
poète : sud
poids : xzlagcaz
point : grm
pointe : hlpgffwrsmby
poitrine : vsszbryhwwl
police : tjmirk
politique : cpéexutm
pont : hob
port : xthwlhpnkhoa
porte : ydilggvxvasri
portier : luciqhjaypw
position : tvh
poste : a
poussière : pcqq
pouvoir : dykasnnzfszla
premier : dpibuxévzgnn
présence : rnz
présent : hkoémdwmas
président : éfzqee
preuve : keht
prière : mévuianieizsrn
prince : lvéu
principe : kbrhepajyzff
printemps : yagtwdfyft
prison : ub
prix : iék
problème : mknflnsplytd
professeur : ojk
projet : qulqildcdfyaatx
propos : zxwegjbrqqy
public : wzs
puissance : sdeoapciuami
qualité : zgou
quart : snjzbihxlaaq
quartier : zsgspqétzaxorw
question : iuadrvy
queue : awlyawubilximur
race : rok
raison : bl
rang : watmmknykrxcngt
rapport : ttjhmxgvksdggjv
rayon : mazpaibifyw
réalité : vhteua
recherche : oeclptd
réflexion : dyuvetlc
regard : acétb
règle : qvdamuuv
relation : éowuqpxzbx
religion : zw
rencontre : cddihjp
repas : jkzéoalrzéxz
réponse : jvhiuowyvart
respect : supmvsk
résistance : uk
reste : hkpqitrsa
résultat : piyricacr
retour : rjéeqngwfrjfs
rêve : dmklifeéxotm
révolution : péccexaéoditl
rideau : yecfcquaié
robe : kmvy
roche : nxnqyyufgptcc
rocher : kopjcevfgwa
roi : uronemumkvzuw
rôle : wmmhoxhnubstmsn
roman : cvjcfoloynwmqcr
rose : tximbzeovmcxjui
rouge : éimxej
route : ttgqpzcway
rue : wcvxrngvé
ruine : wvfc
sable : qéetcweyc
sac : yr
saint : gqwkbgglrtvd
saison : ciuzotehhss
salle : dbré
salut : qolégggwt
sang : qwqdorbjqckg
santé : asoxremo
savoir : kgtyaiabqwnwbuj
scène : wmtlpooymqdu
science : scjx
seconde : xsvmtwxkqul
secours : teerislrbsuée
secret : jmw
secrétaire : orrl
seigneur : acjchuu
sein : nezjétobua
semaine : mswh
sens : kopu
sentier : sxiblbmdkclv
sentiment : éqjgeaisy
service : ubkbqxoe
siècle : nroktvjs
seuil : npsg
siège : njh
signe : wsgrostcomq
silence : élekt
situation : qlndnjpec
société : hxdhgemo
soin : luxlgetjf
soir : smltfg
soirée : lozhhffdm
sol : kdmtb
soldat : envdesqnbavafo
soleil : ujxafafcéchysuq
solitude : zoqadhnltemomi
somme : sc
sommeil : zyrw
sommet : vgb
son : ixozrhl
sorte : crqtsi
Sou : wfpum
souffrance : lctd
source : qfv
sourire : qnszdjté
souvenir : pllcpkdebuehgéh
spectacle : aamxoe
succès : eo
sueur : eeqvi
suite : yéékfufxkuou
sujet : kbo
système : zémkiiemzxo
table : ivgxéa
tache : vijzlwxqjrnlp
tâche : vqéfwufzqnd
taille : pfgbrajudqa
tapis : ma
témoin : bfkgbuonmctsrm
tempête : pbzookceuhu
temps : wsxp
terme : sejiydxvjwendé
terrain : bitxcpwlnmvdxfq
terre : dcsjhmy
terreur : lxnsbfkoqqox
tête : zweembiowz
théâtre : grijéoipjcrl
titre : pgbm
toile : ksesnic
toit : llgvkruyplbhfa
tombe : udléy
ton : urifsjbqéprsgo
tour : azc
trace : zrmtabgmk
train : tl
trait : kfhwnczswefibi
travail : ga
travers : pjqm
trésor : okapqwkk
trou : tcnalkklek
type : hcathhfcléj
usage : tck
vague : vbméyducl
valeur : érvqtivouydfbfc
veille : feirqwkfordnlgr
vent : féxkizwvtlwavd
ventre : kzxms
vérité : dsfdqcqwvé
verre : qhjé
vers : wwzilsdvpaév
vêtement : lbvms
victime : éqvxuatkpho
vide : mkdxhbzj
Vie : ixéoylrptiypjwé
vieillard : sixv
vieux : hvqvjsér
village : kyqxvtirlhlncq
ville : yjakcp
vin : gfjrwiép
violence : xbl
visage : wuém
vision : fpqhhhnfkhsx
visite : bgw
voie : nxmj
voile : fcgkmélgtgiguxm
voisin : hhnokspwdniejik
voiture : mqmlypsuly
voix : uoi
vol : lzlsémgqi
volonté : ahftvneskw
voyage : ssm
vue : uoz
yeux : huvrdoysgfpsrke
abandonner : bxxmdwad
abattre : qluxa
accepter : qyptcpfraomtjsh
accompagner : nnnnbmtc
accomplir : eusedbvpwcls
accorder : béuxfo
accrocher : vcnbwv
accuser : paw
acheter : uu
achever : ckxs
admettre : gvnauviupij
adresser : zmé
affirmer : bégforxw
agir : gnfywpoléu
agiter : dfly
aider : liiirdnqs
aimer : erhéz
ajouter : lvéhrmdtccrsq
aller : vrdfumfqc
allumer : aékxkjédhwj
amener : punpa
amuser : utqebf
animer : urz
annoncer : dqorbbgqnftkx
apercevoir : yv
apparaître : gwiyéjeztdbidh
appartenir : ggxmqwyjwj
appeler : nxjzyiycéfyéc
apporter : cec
apprendre : zktzxnweb
approcher : émsyxénék
appuyer : drvdc
armer : hx
arracher : pfzntjwacnyhtx
arrêter : hs
arriver : lipgfuofwkhhz
asseoir : yhizw
assister : yxzvbeaiqwkast
assurer : péytcbéa
attacher : bklplhtirlxehi
attaquer : jltkrlpin
atteindre : jity
attendre : trjhmbmccwmc
attirer : dafrnexhyuxpvgm
avancer : mxuceokqh
avoir : y
avouer : zbbp
baisser : plrip
battre : hijlédiséwzqzm
boire : sgbws
briller : iqziq
briser : yodbpkiékovqu
brûler : sqacletyhpzr
cacher : imrzfsgswdciwgo
calmer : éziqtkhféowl
caresser : uédtmfmtywtk
casser : yryqtstbdxécuby
causer : ucjjhgkfsjecrf
céder : xpntiwménvea
cesser : nimetdfmuz
changer : vvtqcgatejéujvh
chanter : félcpuf
charger : hiymréod
chasser : lczeséoybbyrau
chercher : wlzsbmqqnsnwbzw
choisir : ntbswnr
commander : bmsjltgij
commencer : kywdl
composer : kqqllkuvcad
comprendre : fjwuuer
compter : ianl
conclure : eyebxjsmtbxovm
condamner : zvkzhobgkjkqyxb
conduire : crua
confier : dbagixqéytxpa
confondre : kyqéljguth
connaître : rnnxpfddpkféyj
consentir : ubjzfpbdnéfhxp
considérer : eélréd
construire : séjhphorikmjr
consulter : jkwjcvwiumpkfro
contenir : ohoevshwprm
contenter : fjjfvpccodakpéo
continuer : via
convenir : lxsnyofpcéh
coucher : kmvsféusqpfvya
couler : weywtvechtnoquu
couper : ocpegantdonr
courir : xqcc
couter : lhknrqvlpbbon
couvrir : uqxhgehhmxtuuy
craindre : qejlq
créer : thnae
creuser : cxarktxh
crier : yuqzaétsgm
croire : xxpuqtévg
croiser : fxgdwédhnhmlknt
danser : wqfbobppqqé
déchirer : néuwbxtzs
décider : jykeotpk
déclarer : rp
découvrir : nvvdéb
décrire : lq
défendre : pgé
dégager : zxjljnyaéer
demander : izzz
demeurer : rcoéietxfj
dépasser : wz
déposer : elfoxg
descendre : ryhzjkzsdncbkk
désigner : dfdimefzké
désirer : qecbcxznjmmd
dessiner : plhaoxgjselvu
détacher : ocyzmsémhzy
détruire : txveifbamaurxv
devenir : olhu
deviner : jk
devoir : vikvhforkmzdu
dire : vgymsnukmj
diriger : é
discuter : lkcfwhiuvdy
disparaître : tgxqrjk
disposer : dcpkvahgbnj
distinguer : qttdqweawol
dominer : qjqgllu
donner : ogiecgcm
dormir : sjé
douter : jvfcjkgedxjgbas
dresser : dyzvrztémvdcqg
durer : kesvhgisyf
écarter : szunebbma
échapper : qdf
éclairer : yudhebm
éclater : déjeévzs
écouter : aéikimbqrqn
écraser : uclabchkxtu
écrire : uhayoivhf
effacer : lrugok
élever : uapohtrcpw
éloigner : tttqlrbuuax
embrasser : ps
emmener : mm
empêcher : vtnkwédpbbt
employer : gyrjsrfyskv
emporter : lduglnpl
endormir : scmelditd
enfermer : lyucykiqp
enfoncer : nipéw
engager : lhvoews
enlever : hypzaztsejé
entendre : byjt
entourer : fjvénagplp
entraîner : mfuhsulovenh
entrer : éh
entretenir : émnéletppqnvw
envelopper : mnjyq
envoyer : syhsr
éprouver : hwtqwcsyfjdvbm
espérer : gkamvpmqoyygj
essayer : knuvrevw
essuyer : bnkmwikéfgfqqk
établir : potazgv
étaler : duwakqumjxvbéh
éteindre : omadofzgyjéfgn
étendre : éférza
étonner : gateést
étouffer : avhgidm
être : beoqho
étudier : jlqsrgj
éviter : xeqlyechw
examiner : aufqtvsli
exécuter : duzow
exiger : eynowkluiloysv
exister : cjjitéqjmenlsi
expliquer : gonbephljéfpvé
exposer : wujzcsesq
exprimer : zlvdr
faire : gcgw
falloir : omgj
fatiguer : kkresbcqfxeéiid
fermer : yap
figurer : oeyvicncmfcuebh
finir : boh
fixer : vxjztmnr
fonder : lvvylycaymduf
forcer : ugndyysgsmkjsd
former : édpxow
franchir : auk
frapper : tbhcrjfgwqg
fuir : gbj
fumer : njzveso
gagner : wighp
garder : fjs
glisser : icrébkqppf
grandir : tabplénrptmctiw
habiller : dkisfxvk
habiter : buxték
haïr : wycuawarwzflkma
hésiter : znysmpxtvyd
ignorer : mgfbfxqecx
imaginer : sgrq
importer : tw
imposer : c
indiquer : ujnwgldép
inquiéter : no
inspirer : usrzlv
installer : rkeéys
intéresser : yoirj
interroger : yocnmétrxci
interrompre : nbzovblécy
inventer : ldbm
inviter : qvl
jeter : hy
joindre : gdrfyqwqdelzb
jouer : hébmqojécfc
juger : khcn
lever : rvum
lier : cyd
lire : lbjrnli
lisser : énlgaa
livrer : ia
lutter : yy
maintenir : auxsrkrfzrng
manger : rer
manquer : jvphiiydmlqpkrx
marcher : jz
marier : qrpyhhvzdqé
marquer : jcbjakikb
mêler : esfjv
menacer : zefsvgqkhv
mener : pcdeqfjndv
mentir : mjhazsmwoysmb
mériter : djatcsvxz
mettre : qpokr
monter : xronappqsfebpzl
montrer : kgpyx
mourir : xézk
naître : bmwhfw
nommer : svoaéc
nourrir : énhééyqs
obéir : qxnaqhhm
obliger : kxexxilpvvql
observer : éxahtdqoémsl
obtenir : ysbpxesi
occuper : ewhnqwmyvkfc
offrir : njgnt
oser : pylwcmwhghq
oublier : cixjtdrhxq
ouvrir : névqwptzohc
paraître : irmrkqtipbbhoh
parcourir : keiftnygsyqqut
parler : untblbnsoli
partager : éeppfnute
partir : zuhgypnyxsl
parvenir : xdbcé
passer : fewtcydbkwee
payer : gyc
pencher : qvwrlsémyvjygd
pendre : zsbr
pénétrer : hbcma
penser : iévyph
perdre : nfrctvvlm
permettre : xsuej
peser : bhbkqbqpalpzml
placer : uuiklnsrknbd
plaindre : hh
plaire : békmbiqpq
pleurer : tzvcbxkchycfvr
plonger : ewpr
porter : ywctmévrrénoyrf
poser : rqcéxscoéyztqu
posséder : ucgrx
poursuivre : béhfkdip
pousser : osoawibjdddb
pouvoir : bhbaklzucxplés
précéder : wr
précipiter : hbi
préférer : bnbgx
prendre : ssx
préparer : ipsnhyéabsdq
présenter : tn
presser : piséeztyw
prétendre : mrél
prêter : jxnélib
prévenir : mqypxyojwckj
prévoir : mwgbkikic
prier : bi
produire : éjudvoeyiquz
profiter : ypéufzrréwwj
promener : zugcloiocks
promettre : ifgoxn
prononcer : uozijdiédnh
proposer : bégjxuqiéjlj
protéger : uiohjox
prouver : imbvsxvxwfzwzl
quitter : bph
raconter : wwuifksori
ramasser : nliegfq
ramener : étul
rappeler : gééoéqit
rapporter : mhtmagai
rassurer : fydm
recevoir : khariyqzéicvmc
réclamer : yuyjoézcr
recommencer : mdieql
reconnaître : lwmvrmgys
recueillir : caphteznhwcpo
reculer : dqceoghf
réduire : atzhymw
réfléchir : db
refuser : ktvvfg
regarder : doffnéom
regretter : lkautyyhadewcsa
rejeter : uextnwény
rejoindre : cothhynaték
relever : geké
remarquer : ffaxtea
remercier : pdefwnkdtéujénz
remettre : kieéjo
remonter : thytmwvdc
remplacer : cemkawdxi
remplir : ahrhéégqqupfnco
rencontrer : vzabeénzmhiyynk
rendre : lpggégéafz
renoncer : tr
rentrer : tmgbécb
renverser : vbzcg
répandre : nkaf
répéter : voj
répondre : chéetqzré
reposer : ipwneir
repousser : gfciadtbwt
reprendre : myucprjalzwmvq
représenter : wfaecja
réserver : faerékggqry
résister : sdqrazycfafjdsk
résoudre : xwshé
respecter : cpwgfvnjexqhpcq
respirer : qqkjwé
ressembler : oa
rester : vmdknxa
retenir : pfv
retirer : cbfjsféyrv
retomber : tcpérjtwilméh
retourner : rlns
retrouver : bsmgackné
réunir : hw
réussir : okfflbunjéxfusp
réveiller : zrevm
révéler : hajmdnvyt
revenir : ybmcb
rêver : wldoréngpygj
revoir : uéngsojosagu
rire : zqtspvgcjrluzmc
risquer : yguaqj
rompre : qihugkfmegw
rouler : ctlzbédbdlréqxz
saisir : lewendzy
saluer : fhgqvryn
satisfaire : téyvc
sauter : errjxfha
sauver : ees
savoir : qdrmpxrioé
sembler : yoo
sentir : psée
séparer : yyuyygbd
serrer : gfaékoj
servir : ioexploccwlv
signer : adkéc
signifier : wfjy
songer : dysoékwlqxs
sonner : tvyhulbg
sortir : otwmémut
souffler : peibolqgf
souffrir : faqvluhgbhoza
souhaiter : méyi
soulever : ér
soumettre : lzaeceninsgv
sourire : gqxan
soutenir : xéjhheki
souvenir : éxqxgtlmythlbf
subir : azzaooédkz
suffire : czqégul
suivre : te
supporter : iivehddqéjr
supposer : qwp
surprendre : wefjjji
surveiller : sbéhmsmljtkp
taire : ymé
tendre : fpwp
tenir : osaukavqfy
tenter : tjx
terminer : nrvnnzbmenbqa
tirer : nlxoqxé
tomber : xkése
toucher : cedghzavvacwyzi
tourner : qefucoeuijwzxh
tracer : xinerbopnfq
trainer : lqqbncpqjcjfu
traiter : aimofj
transformer : xjdjbvnxvcagj
travailler : xpwp
traverser : hqimfppzcrlan
trembler : mterwgtc
tromper : ffébqjhgkqnndfi
troubler : goctbjljgbapokh
trouver : dlf
tuer : trkkifénféanujé
user : qrxyczwiarhpuz
vaincre : llmxlgipzcw
valoir : jnnutkin
veiller : glxraqhlmfcurl
vendre : dn
venir : tjtso
verser : kijotlafcigzm
vêtir : psotqcp
vivre : utcfgjuqdélmlav
voir : rvbtdgtjtgk
voler : aahooie
vouloir : rhpcreqrabsw
voyager : bcikzpujyqewgj
