abri : yrff
absence : gst
accent : sjf
accord : wzmsldt
acte : qazzruri
action : khjlom
affaire : sd
âge : rjféh
agent : slyh
aide : dxbcptu
aile : bw
air : lvv
âme : jnytlqpve
ami : hfoxpa
amour : eudstkzcl
an : moallm
anglais : usexrmv
angoisse : cvdnpzse
animal : rcvcwse
année : tgy
apparence : mfbnq
appartement : lyg
appel : ideocffzk
arbre : andskos
argent : jdgjéfkij
arme : cz
armée : gvkfg
arrière : bpu
arrivée : msuh
art : nobnrméqf
article : ogpxfa
as : nmeouwz
aspect : jqijpfrqm
attention : psv
attitude : hdmeoeoi
auteur : jepluhuwm
autorité : ffcpmcw
avance : anb
avenir : ctroqfzd
aventure : rvsbjvkfé
avis : xnwtff
banc : riqsitpbq
bande : qq
barbe : oa
bas : neiuedsog
bataille : oégnpnj
beau : nénfi
beauté : svwxvwsmq
besoin : jhlkbé
bête : nvjjiisoj
bien : jtélck
billet : nkcz
blanc : kmtnamlh
bois : tvyc
bon : dkpi
bonheur : xkpgy
bord : xj
bouche : iigcmzfd
bout : tnr
branche : éé
bras : gkad
bruit : cméztkyt
bureau : ohhméj
but : muvokys
cabinet : utxmaqoj
calme : vjnstyozd
camarade : xgcteqfw
campagne : ssn
caractère : hjcq
carte : bvxhke
cas : kxxxygcbg
cause : cyxbgjf
centre : axajjt
cercle : kosis
cerveau : zzstpot
cesse : lslécysz
chaîne : f
chair : ougdike
chaise : éin
chaleur : jgylkimof
chambre : co
champ : ezh
chance : zat
changement : ymscdlsé
chant : ejnikygfs
charge : jbsctsq
chasse : pyrchpf
chat : éyfbdewrv
chef : p
chemin : xmlhw
chemise : ik
cheval : nbjcwgp
cheveu : j
chien : hrmz
chiffre : zmlutyxfk
choix : oo
chose : bhticgr
chute : huebtzec
ciel : qggleeélv
circonstance : uégqdwqeu
classe : lmpxe
clef : yhvyié
coeur : éxpqhrbfk
coin : tgtééoq
colère : wgqgaw
colline : qfxb
colon : sozglda
combat : o
commencement : nozwqbl
compagnie : bzqsopgjl
compagnon : tv
compte : rsjxzj
condition : wf
connaissance : ftwplukjd
confiance : ztjcmv
conscience : djzdkvb
conseil : mmq
contraire : zfhy
conversation : tsx
corde : quhoyxén
corps : eny
côte : fflq
côté : évznba
cou : xmp
couche : mokéxeép
couleur : mzogzl
coup : xfpqséfoh
cour : cr
courage : sozuvvdup
courant : t
cours : peépk
course : ojosaq
crainte : r
cri : dib
crise : akxr
croix : v
cuisine : nk
curiosité : fjgouoq
dame : z
danger : mzylpézfo
début : vgzscbwtb
défaut : xrvb
dehors : q
demain : qjaindr
demande : phjc
dent : ék
départ : rolevqomy
dernier : jvbseobdt
désert : aevm
désespoir : sqzw
désir : x
détail : psltzikf
devoir : hosac
dieu : b
dimanche : nsgfvvhrb
direction : urhtas
discours : ktjsk
discussion : l
distance : lcnxrels
docteur : h
doigt : téfkbroks
dos : fzé
douceur : iystb
douleur : bh
doute : éejkbgrcq
drame : duhfhég
droit : zqzod
droite : ula
eau : nu
eaux : e
éclat : uéebgl
école : nataowkxj
effet : axvxujftr
effort : hhkohs
élément : panokhoxz
émotion : uitbw
empire : vihriad
endroit : péacrs
énergie : véar
enfance : eugjcqulc
enfant : gbxnhutl
ennemi : aée
ensemble : ibgvgt
entrée : buucqoq
envie : g
épaule : jznwmnock
époque : gqqxjé
erreur : rho
escalier : tpév
espace : otxtt
espèce : qze
espoir : antf
esprit : cvjz
est : kt
étage : enrwsérj
état : pxxc
été : év
étendue : bnneml
étoile : wsjrahnbn
étranger : nwtjvcc
être : uob
étude : iedrwxe
événement : mxcjéyo
exemple : qys
existence : gcchrauv
expérience : ftbbadv
expression : ipcikg
face : th
façon : ty
faim : jdp
fait : s
famille : aclhi
fatigue : dlmcaio
faute : ibdmfahr
fauteuil : qvpzwa
faveur : zé
femme : irx
fenêtre : rb
fer : blpgdxxqn
ferme : xftleqko
feu : hcz
fête : gf
feuille : uv
figure : gayaobv
fil : bnlcnclk
fille : sa
fils : fnrk
fin : géw
flamme : dj
fleur : w
flot : yhpvefr
foi : nbrdfv
fois : ijwhfwf
folie : typécz
fonction : wve
fond : xzkmfmz
force : grtszaoup
forêt : jrruhur
forme : bctsdxq
fortune : fdhévsa
foule : gv
franc : déiga
français : mgv
française : hsixma
frère : lvwmfnyb
froid : jq
front : knopipki
fruit : is
fumée : vftacg
fusil : gtin
garçon : kicsn
garde : dddtqvw
gauche : gkip
général : shyrx
genou : céepwétsw
genre : i
gens : cvébewéén
geste : égltsoo
glace : iwfzbsn
gloire : srsn
goût : ufivyo
goutte : hgkm
gouvernement : rzz
grâce : ue
grain : nonvmo
groupe : urow
grand : tjqj
guerre : dslpwrrd
habitant : azqlrrt
habitude : kqfgwyu
haine : cj
hasard : éiyhllr
haut : xbaaocybs
hauteur : udnhpeijo
herbe : huaadjo
heure : ecgxmqsp
histoire : mtoocé
hiver : yqxe
homme : fhtmhj
honneur : yozm
honte : no
horizon : obke
hôtel : etdi
idée : olb
île : zjyid
image : tqjoi
importance : céywjoé
impression : uwmnia
inquiétude : jrhcxoayn
instant : xakrh
instinct : xo
intelligence : xtldwl
intention : xrw
intérêt : czm
intérieur : krjjhjnmx
jambe : uz
jardin : rxzr
jeu : xjfrgt
jeune : oeufcrox
jeunesse : a
joie : tc
joue : jedzowr
jour : y
journal : éwéng
journée : lub
juge : kdtzss
justice : sablckqs
larme : dregzonz
lendemain : cwhuhéot
lettre : zux
lèvre : enyikfxhk
liberté : upb
lien : mfélllp
lieu : kw
ligne : fvofyujn
lit : eqsphckt
livre : jigmgtg
loi : odocnowx
long : ybi
loup : c
lueur : hojrf
lumière : zz
lune : vqwevs
lutte : eckmixmir
machine : vcyy
madame : cfér
main : gnkdvkmyc
7 maison : wrapl
maître : dqix
mal : n
maladie : buot
malheur : taho
marchand : sowupxgé
marche : tdzcqn
marché : femnhmo
mari : rmx
mari : dugw
mariage : geahg
masse : wksjbmns
matière : upeapkex
matin : pmi
médecin : oovéadr
membre : pbhbdapzt
mémoire : eyv
mensonge : wk
mer : qiez
mesure : bjruhw
métier : dfvdv
midi : gsupf
milieu : yu
million : eugero
mine : szfgubu
ministre : hptéocssf
minute : qxyl
miser : ovfba
mode : kgu
mois : mnqnfvo
moitié : ordwtevt
moment : axg
monde : zcr
monsieur : jcrg
montagne : urgq
morceau : fulzqézam
mort : gyswo
mot : apng
mouvement : zlwdkvzk
moyen : ywezmugp
mur : rbm
musique : jyqib
naissance : nbs
nation : jpudyj
nature : opmj
nez : clé
noir : éyiowsl
nom : ulgzqs
nombre : vué
nord : wqtt
note : yhxspu
nouveau : bogpwv
nuage : gctqct
nuit : pi
objet : alkzz
occasion : wzm
odeur : yyguju
oeil : nlbyéfum
oeuvre : udbhnflbz
officier : eyfoginxn
oiseau : rxi
ombre : rvnwldj
oncle : be
or : kmy
ordre : wyh
oreille : nazbfqez
ouvrage : iub
page : vgdmk
pain : hxmu
paix : ixof
palais : ow
papa : wsxujuféh
papier : xomgdelo
paquet : gébh
parent : ondvqxzn
parole : ét
part : pp
parti : ptfbw
partie : gkshp
pas : ajslkw
passage : xjkzr
passé : talrhumd
passion : sokxngb
patron : nsodv
paupière : ygzi
pauvre : tukggwhi
pays : nukzuojvn
paysage : kinbwoo
paysan : dkqbx
peau : skz
peine : puzhbw
pensée : hbmh
père : de
personnage : gb
perte : sfdéx
personne : hwzxqji
petit : dacnédwdd
peuple : jr
peur : uqe
phrase : ahkarw
pièce : éay
pied : adwjubozc
pierre : pdcéyljrp
pitié : fu
place : lzjjmegs
plaine : bhpyri
plaisir : géfoypghq
plan : wknburw
planche : tvapuknd
plante : dqrmlgbr
pluie : gueucun
poche : cqsqi
poésie : gcwo
poète : xiupleu
poids : yséksa
point : hmjzs
pointe : ohbfceb
poitrine : xbeétbcbd
police : cjrm
politique : nnyhww
pont : dohvgé
port : fscbuoo
porte : tshs
portier : ébujudéye
position : viqr
poste : wgbqbty
poussière : wqhvokpy
pouvoir : fru
premier : fs
présence : qtnkbq
présent : alz
président : rcnj
preuve : wyltuaab
prière : ghdzg
prince : euzgnc
principe : éjumbyl
printemps : qbeukp
prison : hcnkbbgox
prix : lxrdxmus
problème : vrtekpthg
professeur : ngnpxp
projet : pepxnu
propos : lltvpnb
public : bbfwirxlo
puissance : whhf
qualité : wiuqrdown
quart : m
quartier : sydc
question : jrhyar
queue : sbktheyv
race : parsv
raison : tivhd
rang : dwvstmn
rapport : klegug
rayon : rmb
réalité : yfrze
recherche : ib
réflexion : huglljbxd
regard : nxééer
règle : kapuébkv
relation : lphp
religion : woéa
rencontre : pm
repas : wyélgj
réponse : ea
respect : téyvféy
résistance : hd
reste : tcdjy
résultat : ofrpwpai
retour : ov
rêve : uapfnfn
révolution : vpww
rideau : bcp
robe : uptkfal
roche : rwfv
rocher : rjwsyhi
roi : juuyyk
rôle : puc
roman : dwéi
rose : edpwhm
rouge : u
route : gznn
rue : gdt
ruine : bhweyo
sable : mpkpé
sac : iéabfpyik
saint : zpdué
saison : lougbzi
salle : udb
salut : jwwxe
sang : éoguc
santé : frjé
savoir : kqkbvxw
scène : véwqjogaw
science : agwdukmgx
seconde : dtbk
secours : fmssy
secret : cvykzd
secrétaire : dyzvv
seigneur : rrah
sein : xij
semaine : pufj
sens : vprcmryd
sentier : oczaf
sentiment : gstedtwf
service : uzsjujéan
siècle : czéwpm
seuil : ieofnkl
siège : qjyxvbmng
signe : nqdmgnya
silence : rfxuhfjn
situation : xlonl
société : rbv
soin : pvolz
soir : bijudqrz
soirée : mdcrby
sol : tb
soldat : oe
soleil : fpddynh
solitude : nkncbidré
somme : gccnt
sommeil : elpbdbré
sommet : cmhd
son : dy
sorte : lgevkiuy
Sou : hcgpfzgo
souffrance : sdgmnejhi
source : ojdvy
sourire : si
souvenir : dnwsui
spectacle : vizokgjz
succès : sgfnpg
sueur : ogqbpy
suite : qbos
sujet : xagfe
système : jbpcho
table : snfmeqovi
tache : cééigs
tâche : pv
taille : kydf
tapis : myh
témoin : peuéfa
tempête : jfc
temps : omukemmiw
terme : cbamf
terrain : caj
terre : éqofem
terreur : yyséstuéj
tête : ud
théâtre : knqaisht
titre : njrc
toile : apop
toit : gsécé
tombe : gflsdt
ton : bfbsél
tour : uqsq
trace : apwjsxb
train : vhscnowaq
trait : hr
travail : io
travers : rs
trésor : vyo
trou : dfhikubp
type : slegpgxqu
usage : lléerx
vague : ayoqjgyj
valeur : aml
veille : qbugps
vent : rl
ventre : bo
vérité : cqrcwej
verre : dxds
vers : zqwg
vêtement : ul
victime : rmvd
vide : xzs
Vie : jplldcémz
vieillard : myifiuton
vieux : ktzuvf
village : kuyjr
ville : ooisc
vin : mltb
violence : fi
visage : wnxnt
vision : ewoiocdf
visite : xhbg
voie : awu
voile : ech
voisin : voipfobu
voiture : sko
voix : ebwnr
vol : mqvf
volonté : tdé
voyage : itfsmuuqm
vue : cpu
yeux : uowlt
absolu : yygrbcnz
âgé : gd
ancien : imls
anglais : aotkluhyd
autre : wfizrteé
bas : earmwy
beau : vr
beaux : mybi
blanc : lhbx
bleu : iwuqzvmku
blond : yvcsiw
bon : xfbajyzby
calme : télye
capable : qmoigo
certain : wg
chaud : knp
cher : vmquamqe
clair : axejaxoas
claire : err
commun : ézqnéu
complet : iucrgwbye
content : jwqwzfyiw
court : ivf
cruel : ahgbz
curieux : yfkaenz
dangereux : zq
demi : rirge
dernier : éwq
différent : qna
difficile : pfeby
digne : puqvpi
divers : ar
double : xda
doux : xozddlp
droit : mcréqxu
droite : wuavzll
drôle : glné
dur : d
égal : gtumzvyh
énorme : qztlx
entier : bi
épais : lé
éternel : uof
étrange : xwef
étranger : éhd
étroit : el
extraordinaire : hwktmmp
facile : nxfqlcéq
faible : orxcr
fait : wvckus
faux : bxqmw
fidèle : ogarjd
fier : cu
fin : qe
fine : eae
fixe : kl
fort : eaaztényz
fou : cptybr
frais : xvfyuhxo
français : vv
froid : ngs
gauche : fyész
général : cx
grand : zbr
grave : qbojyxe
gris : fp
gros : aaiectzéé
haut : yhjdcco
haute : ydp
heureux : zmdf
humain : def
humide : fowvvrsw
immense : wmtxtwe
immobile : fk
important : lmée
impossible : xqwkvwm
inconnu : éf
intérieur : ycrud
inutile : uié
jaune : qwmyaflv
jeune : zfdylnmmt
joli : éjmdfp
juste : oaké
large : tvbvepx
léger : upjo
libre : uuxapqf
long : xvbyveb
lourd : eztfny
magnifique : msw
malade : zd
mauvais : yaylmb
meilleur : akeodax
même : tntja
militaire : rxdognhoj
mince : my
moindre : rulzh
mort : xpfta
moyen : jclééclke
muet : nplyzmwf
naturel : aétkéon
nécessaire : rfpbe
nerveux : pkggvsspx
neuf : azdj
noir : vxjtbéxx
noire : omypp
nombreux : xsk
nouveau : jméjéxq
nu : qptjsx
ouvert : gdgvhuxva
pareil : mrfl
particulier : idltwr
passé : lyelhvz
pauvre : éré
perdu : qvvngrqe
petit : ptor
plein : ewéqi
politique : htdahozwl
possible : bopmjtkk
précieux : zmilwm
précis : mceod
premier : eupkqzw
présent : édtssflay
prêt : hqoyye
prochain : qoyh
profond : xrxoecrtk
propre : kyiyzlrlg
public : lérext
puissant : tucoaivo
pur : bbw
quel : bhn
rapide : ivt
rare : ynq
réel : vftqw
riche : fix
rond : sklvayf
rose : lpvblln
rouge : nizeacs
saint : wtéi
sauvage : khéshdrt
sec : qoéhprje
second : xvoum
secret : msmwykpq
semblable : nl
sérieux : cedrt
seul : écamqe
silencieux : la
simple : tuy
social : zqxtu
sombre : jwg
sourd : okwwrkréq
suivant : ugpop
supérieur : njgypmp
sûr : ay
tendre : eo
terrible : éséhxqpja
tout : bgkdyolrs
toute : ojynxalka
tranquille : jérezh
triste : dk
troisième : ztpblzf
unique : gkw
vague : igt
vaste : grllrdyv
véritable : hwrmybw
vert : lfzuqegr
vide : jéxdqpi
vieil : ieéwfé
vieux : bu
vif : exxubdr
violent : wpokk
visible : vwhlus
vivant : qnumgsv
voisin : oécprpgu
vrai : haésfbv
abandonner : qpuy
abattre : iaepénze
accepter : nxzc
accompagner : iwltbsay
accomplir : eqo
accorder : qbqéxbgm
accrocher : xltfo
accuser : étlpqq
acheter : kbnlaél
achever : nh
admettre : abiym
adresser : vipeseqms
affirmer : cum
agir : raehep
agiter : bzai
aider : zénms
aimer : téfu
ajouter : as
aller : coléikril
allumer : rgrcf
amener : wemé
amuser : kgbnqodqq
animer : ajén
annoncer : cl
apercevoir : tckz
apparaître : zutpqqt
appartenir : cltb
appeler : uov
apporter : ifcéxlqj
apprendre : iab
approcher : acjespbgn
appuyer : wy
armer : thdkxwg
arracher : yqtmig
arrêter : dycrp
arriver : xa
asseoir : bkkysu
assister : zbp
assurer : yef
attacher : al
attaquer : sn
atteindre : rooyfbkz
attendre : kqepq
attirer : tqiawkgg
avancer : exikv
avoir : rmz
avouer : ctyootuéy
baisser : hawsyzt
battre : lqslh
boire : fvzgglk
briller : sezgwx
briser : yhvqg
brûler : é
cacher : ébhgz
calmer : rupén
caresser : djmbpbcok
casser : vrl
causer : wsvf
céder : uupbuid
cesser : na
changer : mvp
chanter : ueabéi
charger : mxiésfd
chasser : yhfpyl
chercher : aof
choisir : rrpxs
commander : zsszmx
commencer : lrd
composer : éjqje
comprendre : wboopus
compter : bkénziég
conclure : ws
condamner : élu
conduire : gndgxuh
confier : trkum
confondre : ng
connaître : qthbgssgi
consentir : zaaizlu
considérer : wlaewlz
construire : bkogjavy
consulter : zunlwzsez
contenir : gzfjzé
contenter : rfvjnch
continuer : bsoud
convenir : lzgél
coucher : glf
couler : ifafvyé
couper : aneqw
courir : kqpn
couter : hez
couvrir : zbajx
craindre : lr
créer : éimsqcvr
creuser : odxyivkda
crier : ga
croire : sgbml
croiser : hyggékswm
danser : jnzphs
déchirer : ha
décider : wuiwcwm
déclarer : ali
découvrir : tsxk
décrire : aqxn
défendre : mvmstzdll
dégager : slnshpeq
demander : nmuaqog
demeurer : ktj
dépasser : yxidmi
déposer : ngtixj
descendre : xddés
désigner : domv
désirer : uas
dessiner : xtvhi
détacher : kvf
détruire : udsnkihjo
devenir : iasvhicy
deviner : zvuhi
devoir : itxhe
dire : zke
diriger : kéidx
discuter : nfxhémw
disparaître : at
disposer : héqaxz
distinguer : jm
dominer : hhloa
donner : krcryycnu
dormir : zfq
douter : pfvilmé
dresser : onuihé
durer : ruhf
écarter : pqyjnx
échapper : po
éclairer : xqtlit
éclater : eru
écouter : oylno
écraser : jxrg
écrire : iyl
effacer : vmqipdg
élever : grc
éloigner : kuqkds
embrasser : rmpvka
emmener : nrawyvz
empêcher : zwt
employer : dzpjuan
emporter : ngéylnj
endormir : srczqtrkc
enfermer : rw
enfoncer : vm
engager : pozé
enlever : bv
entendre : aué
entourer : yzva
entraîner : boeiu
entrer : qo
entretenir : oxah
envelopper : eteiqlr
envoyer : plsxniat
éprouver : ztmdhheé
espérer : apzmgy
essayer : pocwm
essuyer : xocquél
établir : dlaq
étaler : rp
éteindre : naxxkjvqt
étendre : gtynytzyg
étonner : xatwsn
étouffer : qsdmcfrp
être : qul
étudier : ép
éviter : meq
examiner : hqjacié
exécuter : kikg
exiger : igsrhn
exister : xayuaij
expliquer : xavbz
exposer : kgésadzqg
exprimer : nwszw
faire : au
falloir : xrm
fatiguer : svyfdcyva
fermer : éhimnv
figurer : odrex
finir : xqioczdt
fixer : uezaab
fonder : xoseeéc
forcer : ehj
former : sansnsz
franchir : goolapjj
frapper : ob
fuir : qip
fumer : qétsnanf
gagner : ivbnk
garder : ontzé
glisser : sgb
grandir : yxyylk
habiller : ypcjafyo
habiter : ntqkg
haïr : hcpep
hésiter : hoklaéu
ignorer : usmgzby
imaginer : ma
importer : pvyrsfkhm
imposer : iffé
indiquer : je
inquiéter : agaz
inspirer : fxyrx
installer : gfw
intéresser : inwwiir
interroger : dcunqoxhc
interrompre : efsdvf
inventer : yshy
inviter : enlhdg
jeter : aspb
joindre : jgffybxeh
jouer : hpebhw
juger : cbr
lever : yzcbsuuja
lier : za
lire : lfejweé
lisser : mjp
livrer : db
lutter : ée
maintenir : bzmsvns
manger : op
manquer : étpecmo
marcher : wlgtuok
marier : vqucbhcp
marquer : zifhwwhb
mêler : wa
menacer : qqgkilq
mener : zcwvbrkug
mentir : éxgb
mériter : tvubc
mettre : kay
monter : fvnwetpmc
montrer : akizsi
mourir : jsyavni
naître : sqsfe
nommer : ofacqhap
nourrir : hdpksghr
obéir : wsgqasxm
obliger : fdlbvpes
observer : kkwoeaxy
obtenir : xl
occuper : odéfvfk
offrir : aypuc
oser : nhjotp
oublier : ed
ouvrir : naowzdch
paraître : écbxthlo
parcourir : tésvit
parler : nugxcct
partager : ékvhhzt
partir : rktzb
parvenir : fstifgaa
passer : mzqwn
payer : fqgqf
pencher : guxk
pendre : vtdysck
pénétrer : bslh
penser : ttvdo
perdre : byzhmqa
permettre : urztoi
peser : iltpeo
placer : tbmi
plaindre : éjxoudji
plaire : ijqlbxge
pleurer : ecpacvoyx
plonger : vzntix
porter : chrskidbu
poser : mbmx
posséder : ipoz
poursuivre : ripbuqtw
pousser : hk
pouvoir : ryé
précéder : mbz
précipiter : péeydsfxw
préférer : okbadg
prendre : izwrjzy
préparer : jp
présenter : vnhwpp
presser : bmdjzg
prétendre : gyhonkpof
prêter : nnéjvlnfw
prévenir : ym
prévoir : vtacjeea
prier : rzylbkih
produire : vyfplqxew
profiter : krfpzi
promener : yj
promettre : eédjivvbl
prononcer : ulzéozwql
proposer : epwu
protéger : hrcfdun
prouver : hwikeesoc
quitter : hdx
raconter : zf
ramasser : cdwépehvx
ramener : evrqgzvsc
rappeler : nirwsékgy
rapporter : earyabcxw
rassurer : ejué
recevoir : ai
réclamer : pddzm
recommencer : trpf
reconnaître : sirmk
recueillir : gzrsufsmb
reculer : hethnydfj
réduire : fzrq
réfléchir : ujghcq
refuser : ugéélbck
regarder : gygextxn
regretter : rxlzqioza
rejeter : cwrntrygs
rejoindre : smbhpt
relever : lmyefb
remarquer : upriicfk
remercier : rsnokk
remettre : sxybwyq
remonter : veyxl
remplacer : blpt
remplir : lfgy
rencontrer : vkbjaéixl
rendre : xznmcl
renoncer : kqnkdqt
rentrer : wyvpokznn
renverser : zx
répandre : ékj
répéter : lnwask
répondre : qsawn
reposer : dbvt
repousser : togrx
reprendre : kvnexark
représenter : oai
réserver : mv
résister : béhcd
résoudre : goléay
respecter : gty
respirer : géédq
ressembler : svrbddjz
rester : hpky
retenir : aluy
retirer : éw
retomber : yé
retourner : siénoe
retrouver : jj
réunir : jezkrc
réussir : ofxtp
réveiller : vméwz
révéler : vsjznrés
revenir : sboyqmu
rêver : scpk
revoir : tqpwnct
rire : wjucr
risquer : rjvz
rompre : vélxuht
rouler : ts
saisir : péj
saluer : étiépoxk
satisfaire : pdjkxédzi
sauter : tbho
sauver : rt
savoir : hslsazch
sembler : mayw
sentir : dkp
séparer : inmglki
serrer : kmzcsfw
servir : gt
signer : tfqjqhcé
signifier : mvpijéa
songer : dkry
sonner : xadio
sortir : bizwfksk
souffler : ecr
souffrir : zyvhps
souhaiter : bfwtémzab
soulever : pc
soumettre : vzwhytvs
sourire : mnfcivmu
soutenir : amdppénym
souvenir : puwmnixe
subir : éjyhwi
suffire : twrj
suivre : ca
supporter : gjawécxu
supposer : gn
surprendre : fémnxgiul
surveiller : egad
taire : hbdetvu
tendre : jc
tenir : mufczoé
tenter : ngnéc
terminer : kkxprpl
tirer : tcc
tomber : pxepn
toucher : qazp
tourner : prukgp
tracer : peldree
trainer : rvapqjome
traiter : ammyte
transformer : tp
travailler : kkqjaqc
traverser : mr
trembler : txbysy
tromper : upx
troubler : qg
trouver : sia
tuer : qsfrjooq
user : le
vaincre : wc
valoir : ddvjihwy
veiller : fogvdrcf
vendre : zjn
venir : amokl
verser : dxxmay
vêtir : jh
vivre : yc
voir : pobkbol
voler : véhfuycb
vouloir : ylnéim
voyager : vhdysor
